32 20
200 490
 1  2  3  4  7  7 13  7  7  7  7  7  7  7  7  7  7  7  7  7  7  7  7  7  7  7  7  7  7  7  7  7
 0  0 17 12  7 49  7  7  5  7  7 19  7  7  7  7 21  7 19  7  7 -2  7 49  7  7 18  7  7 13  7 19
 8 36 23 34 13  7 21  7  7 -2  7  7  7  7  7  7  7 -2  7  7  7  7 24 20  7  7  7  7  7  7  7  7
43 44 34 25  7  7  7  7  7  7  7  7  7 -2  7  7  7 28  8  8  8 36 23 37  8  8 30 31  7  7  7  7
 5  5 -2  7  7 21 49  7 21  7  7  7  5  6  7  7  7  3 15 14 14 14 27 14 14 14  3  4 19  7 21  7
 7  7  7  7  7  7  7  7  7  7  7  6 21  7  7 13  7  3 22  0  0  0  0  0  0  0 17  4 48 21  7  7
28  8  8  8  8  8 30 31  7  7  7  7  7  5  7  7  7  3 22  2  0 -1  0  1  0  0 27 34 20  7  7  7
 3 15 14 14 14 14  3  4 13  7 19  7 -2  7  7  7  7  3 22  0  0  0  0  2  0  0 23 27 23 37  8 30
17 22  1  0  0  0 17 12  7  7  7  7  7  7  7  7 28 51 22  0  0  1  0 -1  0  0 33 14 14 14 14  3
32 22  0  2  0  2 27 26 24  7  5  7  7 21  7  7  3 15 16  0  0  0  0  0  2  0  0  0  0  2  0  3
 3 22  0 11 23  2  1 24  7  7  7  7  7  7  7  7  3 22  1  0 28  8  8 10 11  0  2  0  1  0  0  3
50 30  2  0  0  0 27 20  7  7 13  7  7  7 13  7  3 22  0  0  3 15 14 14 16  0  0 -1  0  0  0  3
 5 47  8  8  8 36 23 25 19 21  7  7  7  7  7  7  3 22  0  0  3 22  0  0  0  0  0  0  0  1  0  3
 6  3 15 14 14 14 27 20 13  7  7  7  7 28  8  8 40  8  8  8 51 22  0 -1  0  0  0  0  0 -1  0  3
28 51 22  0  0  2 23 24  7 19 -2  7  7  3 15 14 14 14 14 14 14 16  0  0  0 27 37  8  8  8  8 51
 3 15 16  2  1  0 27 23  7 13  7  7  7 17 22  0  1  0  0  0  0  0  0  2  0 32 49 43 43 43 43 43
 3 22  0  0  0  2 27 27 34 20  7  7 20 27 16  0  0  0  2 -1  0  0  0  0  0  3 12  5  7  6  6 13
 3 22  0 -1  0  1 33 23 25  7  7  7 48 25 27  0 23 27  0  1  0  1  0  0  0  3  4 -2  6  5 20  7
 3 22  2  0  2  0 28 36 34 48  7  7 49 24 26 34 26 34 37 36 11  0  0 29  8 40  8  8 36 34 37 30
50  8 36 37  8  8 51  7 48  7  7  7  7  7 48  7 48 32 15 14 16  2  0 33 14 14 14 14 14 27 14  3

