37 24
500 640
28  8  8  8  9  8  8  8  8  8  8  8  8  8  8  8  8  8  8  8  8  8  8  8  8  8  8  8  8  8  8  8  8  8  8  8 30
 3 15 14 14  3  7 7  7  7  7 -4 -5 -3  7 7  7  7 7  7  7  7 7  7 -3 -5 -4 -3 -5 -4  7  7 -3  7 -4 -3  7  3
 3 22 -1  0  3  7  7  7  7  7  7  7  7 -3  7  7  7  7 -3  7  7  7 -3 -4 -3 -5  7  7 -5  7  7  7 -3  7 -5  7  3
 3 22  0  0 50  8  8  8  8 30 31  7  7 -3  7  7  7  7  7  7  7 -3 -4 -5 -4 -3 -4 -2 -3  7  7  7 -4 -3  7  7  3
 3 22  0  0  0  0  0  0  0  3  4  7  7  7  7  7  7 7  7  7  7  7  7  7  7 -4  7  7  7 -5  7  7  7 -5 -3  7  3
 3 22  0  0  0  1  0  0  2  3  4  5  6  5  6  5  7  7  7  5  7  7  7  7  7  7  5  5  6  5  7  5 -2  5 -3  6  3
47  8  8  8  8  9 10 11  0  3 12  7  5  7  7 -2 13  7  7  7  7 -2  7  7 7  7  7  7  7  7  7  7  7  7  7  5  3
 3  0  0  0 14  3 15 16  0 17 12  7  7  7 18 19  7  7  7 20  7  7  7  7  7  7  7  7  7 21  7  7 -3  7  7  7  3
 3  0 -1  0  1 17 22  2  0 23 24  7  7 13 19  7  7  7 13 25 26 21  7  7  7  7 19 18 19 13  7  7  7  7  7  5  3
 3  0  0  0 27 23 22  0 27 23 18  7  7 21 13  7  7 28 10 11  0 29 30 31 13  7 21 19  7  7  7  7  7  7 -4  7  3
 3  0  0  0  0 23 27  0  2 32 31 13  7  7  7  7  7  3 15 16  0 33  3  4  7  7  7 18 13  7 13 19 18 34  7  7  3
 3  0  0  0  0 32 22  0  0 35  4  7  7  7  7 13 18 35 22  0  0  0  3  4 21  7  7  7  7  7 28  8 36 23 23 37 52
 3 -1  0  0  0  3 22  0  1 33 25 20  7 38 39 26 25 33 16  0 -1  2 35 12 13  7  7  7  7 13 35 15 14  0 27 14  3
 3  0  0  0  2  3 22  0  0  0 38 13  7  7  7 20 25  2  0  2  1  0 33 39 26 20  7  7 38 26 33 16  0  0  0  0  3
47  8  8  8  8 40 10 11  0 41 31 18  7  7  7  7 13 42 11  0  0  0  0 26 38  7  7 20 39 26  0  0  1 -1  0  2  3
 3 43 44 43 43 44 44 25 26 45 46  7  7 7  7  7 18  3 22  0  2  0 42  4 13  7  7  7  7  7 42 11  0  0  0  0  3
 3  7 -3  7  7 13 21 20 25 13  7  7  7  7  7  7 21  3 22  0  0  0  3 12  7  7  7  7  7  7 47  8  8 10 11  0  3
 3  7  7 -3  5  7  7  7 48  7  7 13 49 18  7  7  7 50 10 11  0 29 51  4  7  7  7  7  7 18  3 15 14 14 16  0  3
 3 18  7  7  6  5 7  7  7  7  7  7  7  7  7  7  7 45 44 20 25 44 43 46  7  7  7 13 18 21  3 22  0  0  2  1  3
 3  7 7  7  6  6  5  7  7  7  7  7  5  7  7  7  7  7  7 18 20 13  7  7  7 28  8  8  8  8 52 22  2 41 11  0  3
47  8  8  8  8  8  8  8  8 30 31  7  7  7 -3  7  7  7  7 13  7  7 -3  7 18  3 15 14 14 14  3 22  0 33 16  0  3
17 15 14 14 14 14 14 14 14  3 12 -3  5  6  5  7  7 -2  7  7 -3 -4  7  7 13  3 22  2  0  0  3 22  0  0  0  0  3
 0  0  0  0  0  1  0  0  2  3  4  7  6 7  6  5  7  5  7  7  7  7 7  7  7  3 22  0  1  2  3 22  0 41 11  2  3
37  8  8  8  8  8  8  8  8 40  8  8  8  8  8  8  8  8  8  8  8  8  8  8  8 40  8  8  8  8 40  8  8  8  8  8 51


